11111111111111
10P01101E00111
1110C001001001
11111111111111
10000C00000001
11111111111111