1111111111111111111111111111111111
100000000000E000000000000000000001
1000000000000000000000000000000001
1000000000000000000000000000000001
100000P00000000000C000000000000001
1111111111111111111111111111111111