1111111111111
1000000000001
1000000000001
1000000000001
1000000CE00P1
1111111111111