111111111111
100P10C00C01
1C0000001001
1110E0000001
1000C0000001
111111111111

