11111
100P1
1C001
110E1
11111

11111
10P01
1C001
110E1
11111