111111111
100P10C01
1C0000001
110E00001
111111111
