11111111111111
1P0000E00000C1
11111111111111
10000000000001
11111111111111
